Sex	binary
Age	gaussian
HighestEducation	gaussian
HeightInches	gaussian
WeightPounds	gaussian
RelationshipStatus	gaussian
DivorceCount	ZIpoisson
LongestRelationship	gaussian
RelationshipNumber	gaussian
ChildrenNumber	ZIpoisson
HouseholdIncome	gaussian
RetirementAccount	binary
RetirementPercentStocks	ZINB
RentOwn	binary
MortgageDebt	poisson
CarDebt	poisson
EducationDebt	poisson
CreditCardDebt	poisson
OtherDebtAmount	poisson
CoffeeCupsPerDay	ZINB
TeaCupsPerDay	ZINB
CaffienatedSodaCansPerDay	ZINB
CaffieneOtherSourcesDayMG	gaussian
GamblingProblem	gaussian
TrafficTicketsLastYearCount	ZIpoisson
TrafficAccidentsLifeCount	ZIpoisson
ArrestedChargedLifeCount	ZINB
LifetimeSmoke100Cigs	binary
HowLongSmoked	ZIpoisson
SmokeEveryDay	ZIpoisson
CigsPerDay	ZIpoisson
HowSoonSmokeAfterWaking	ZIpoisson
AlcoholHowOften	poisson
AlcoholHowManyDrinksDay	gaussian
AlcoholHowOften6Drinks	ZINB
HowOftenCantStopDrinking	ZINB
HowOftenFailedActivitiesDrinking	ZINB
HowOftenDrinkMorning	ZIpoisson
HowOftenGuiltRemorseDrinking	ZINB
HowOftenUnableRememberDrinking	gaussian
InjuredDrinking	gaussian
RelativeFriendConcernedDrinking	gaussian
CannabisPast6Months	binary
CannabisHowOften	ZIpoisson
CannabisHoursStoned	ZIpoisson
HowOftenCantStopCannabis	ZIpoisson
HowOftenFailedActivitiesCannabis	ZIpoisson
HowOftenDevotedTimeCannabis	ZIpoisson
HowOftenMemoryConcentrationProblemCannabis	ZIpoisson
HowOftenHazardousCannabis	ZINB
CannabisConsideredReduction	ZIpoisson
AbuseMoreThanOneDrugAtATime	binary
AbleToStopDrugs	binary
BlackoutFlashbackDrugUse	binary
FeelBadGuiltyDrugUse	binary
SpouseParentsComplainDrugUse	binary
NeglectedFamilyDrugUse	binary
EngagedInIllegalActsToObtainDrugs	binary
WidthdrawalSymptoms	binary
MedicalProblemsDueToDrugUse	binary
Nervous	poisson
Hopeless	ZIpoisson
RestlessFidgety	poisson
Depressed	ZIpoisson
EverythingIsEffort	ZIpoisson
Worthless	ZIpoisson
Last30DaysUsual	gaussian
DaysLostLastMonth	gaussian
DaysHalfLastMonth	gaussian
DoctorVisitsLastMonth	gaussian
DaysPhysicalHealthFeelings	ZIpoisson
BMI	gaussian
Obese	binary
